16
16
5
5
50
LLLLLLLLLLLLLLLL
LLWWWWWWWWWWWWLL
LWWWWWWWWWWWSSLL
LWWWWWWWWWWWSSLL
WWWWWWWWWWSSSLLL
WWWWWWWWWSSLLLLL
WWWWWWWWSLLLLLLL
LLWWWWLLLLLLLLLL
LLWWWLLLLLLLLLLL
LLWWWWWWLLLLLLLL
LLWWWWWWWWWLLLLL
LLLLWWWWWWWWWWLL
LLLLWWWWWWWWWWLL
LLLLLLWWWWWWWLLL
LLLLLLLWWWWWLLLL
LLLLLLLLWWWLLLLL
LLLLLLLLLLLLLLLL